Unnamed: 0,Rank,NOC,Gold,Silver,Bronze,Total,Year,Host,Number_of_people
0,1,United_States,11,7,2,20,1896,0,14
1,2,Greece,10,18,19,47,1896,1,101
2,3,Germany,6,5,2,13,1896,0,19
3,4,France,5,4,2,11,1896,0,12
4,5,Great_Britain,2,3,2,7,1896,0,10
5,6,Hungary,2,1,3,6,1896,0,7
6,7,Austria,2,1,2,5,1896,0,3
7,8,Australia,2,0,0,2,1896,0,1
8,9,Denmark,1,2,3,6,1896,0,3
9,10,Switzerland,1,2,0,3,1896,0,3
10,11,Mixed_team,1,0,1,2,1896,0,3
11,1,France,27,39,37,103,1900,1,536
12,2,United_States,19,14,15,48,1900,0,59
13,3,Great_Britain,15,7,9,31,1900,0,39
14,4,Mixed_team,8,5,6,19,1900,0,39
15,5,Belgium,6,7,4,17,1900,0,28
16,6,Switzerland,6,2,1,9,1900,0,15
17,7,Germany,4,3,2,9,1900,0,33
18,8,Italy,3,2,0,5,1900,0,23
19,9,Australia,2,0,3,5,1900,0,2
20,10,Denmark,1,3,2,6,1900,0,11
21,11,Hungary,1,2,2,5,1900,0,18
22,12,Cuba,1,1,0,2,1900,0,1
23,13,Canada,1,0,1,2,1900,0,4
24,14,Spain,1,0,0,1,1900,0,4
25,14,Luxembourg,1,0,0,1,1900,0,1
26,16,Austria,0,3,3,6,1900,0,15
27,17,Norway,0,2,3,5,1900,0,7
28,17,Netherlands,0,2,3,5,1900,0,18
29,19,India,0,2,0,2,1900,0,1
30,20,Bohemia,0,1,1,2,1900,0,7
31,21,Sweden,0,0,1,1,1900,0,10
32,1,United_States,76,78,77,231,1904,1,417
33,2,Germany,4,5,6,15,1904,0,22
34,3,Canada,4,1,1,6,1904,0,9
35,4,Cuba,3,0,0,3,1904,0,3
36,5,Hungary,2,1,1,4,1904,0,4
37,5,Mixed_team,2,1,1,4,1904,0,4
38,7,Norway,2,0,0,2,1904,0,3
39,8,Austria,1,1,1,3,1904,0,2
40,9,Great_Britain,1,1,0,2,1904,0,6
41,10,Switzerland,1,0,2,3,1904,0,3
42,11,Greece,1,0,1,2,1904,0,11
43,12,Australia,0,3,1,4,1904,0,2
44,13,France,0,1,0,1,1904,0,1
45,1,Great_Britain,56,51,39,146,1908,1,550
46,2,United_States,23,12,12,47,1908,0,119
47,3,Sweden,8,6,11,25,1908,0,151
48,4,France,5,5,9,19,1908,0,182
49,5,Germany,3,5,5,13,1908,0,80
50,6,Hungary,3,4,2,9,1908,0,56
51,7,Canada,3,3,10,16,1908,0,76
52,8,Norway,2,3,3,8,1908,0,55
53,9,Italy,2,2,0,4,1908,0,66
54,10,Belgium,1,5,2,8,1908,0,58
55,11,Australasia,1,2,2,5,1908,0,30
56,12,Russian_Empire,1,2,0,3,1908,0,30
57,13,Finland,1,1,3,5,1908,0,62
58,14,South_Africa,1,1,0,2,1908,0,14
59,15,Greece,0,3,1,4,1908,0,20
60,16,Denmark,0,2,3,5,1908,0,78
61,17,Bohemia,0,0,2,2,1908,0,19
62,17,Netherlands,0,0,2,2,1908,0,109
63,19,Austria,0,0,1,1,1908,0,7
64,1,United_States,26,19,19,64,1912,0,172
65,2,Sweden,23,25,17,65,1912,1,365
66,3,Great_Britain,10,15,16,41,1912,0,225
67,4,Finland,9,8,9,26,1912,0,132
68,5,France,7,4,3,14,1912,0,99
69,6,Germany,5,13,7,25,1912,0,162
70,7,South_Africa,4,2,0,6,1912,0,21
71,8,Norway,3,2,5,10,1912,0,147
72,9,Canada,3,2,3,8,1912,0,28
73,9,Hungary,3,2,3,8,1912,0,112
74,11,Italy,3,1,2,6,1912,0,66
75,12,Australasia,2,2,3,7,1912,0,16
76,13,Belgium,2,1,3,6,1912,0,31
77,14,Denmark,1,6,5,12,1912,0,131
78,15,Greece,1,0,1,2,1912,0,22
79,16,Russian_Empire,0,2,3,5,1912,0,22
80,17,Austria,0,2,2,4,1912,0,80
81,18,Netherlands,0,0,3,3,1912,0,33
82,1,United_States,41,27,27,95,1920,0,285
83,2,Sweden,19,20,25,64,1920,0,245
84,3,Finland,15,10,9,34,1920,0,63
85,4,Great_Britain,14,15,13,42,1920,0,225
86,5,Belgium,14,11,11,36,1920,1,318
87,6,Norway,13,9,9,31,1920,0,134
88,7,Italy,13,5,5,23,1920,0,173
89,8,France,9,19,13,41,1920,0,298
90,9,Netherlands,4,2,5,11,1920,0,122
91,10,Denmark,3,9,1,13,1920,0,151
92,11,South_Africa,3,4,3,10,1920,0,38
93,12,Canada,3,3,3,9,1920,0,52
94,13,Switzerland,2,2,7,11,1920,0,77
95,14,Estonia,1,2,0,3,1920,0,14
96,15,Brazil,1,1,1,3,1920,0,19
97,16,Australia,0,2,1,3,1920,0,13
98,17,Japan,0,2,0,2,1920,0,15
99,17,Spain,0,2,0,2,1920,0,58
100,19,Greece,0,1,0,1,1920,0,47
101,19,Luxembourg,0,1,0,1,1920,0,25
102,21,Czechoslovakia,0,0,2,2,1920,0,118
103,22,New_Zealand,0,0,1,1,1920,0,4
104,1,United_States,45,27,27,99,1924,0,296
105,2,Finland,14,13,10,37,1924,0,121
106,3,France,13,15,10,38,1924,1,391
107,4,Great_Britain,9,13,12,34,1924,0,261
108,5,Italy,8,3,5,16,1924,0,196
109,6,Switzerland,7,8,10,25,1924,0,141
110,7,Norway,5,2,3,10,1924,0,54
111,8,Sweden,4,13,12,29,1924,0,154
112,9,Netherlands,4,1,5,10,1924,0,174
113,10,Belgium,3,7,3,13,1924,0,165
114,11,Australia,3,1,2,6,1924,0,36
115,12,Denmark,2,5,2,9,1924,0,86
116,13,Hungary,2,3,4,9,1924,0,89
117,14,Yugoslavia,2,0,0,2,1924,0,42
118,15,Czechoslovakia,1,4,5,10,1924,0,132
119,16,Argentina,1,3,2,6,1924,0,72
120,17,Estonia,1,1,4,6,1924,0,37
121,18,South_Africa,1,1,1,3,1924,0,30
122,19,Uruguay,1,0,0,1,1924,0,26
123,20,Austria,0,3,1,4,1924,0,49
124,20,Canada,0,3,1,4,1924,0,65
125,22,Poland,0,1,1,2,1924,0,65
126,23,Haiti,0,0,1,1,1924,0,8
127,23,Japan,0,0,1,1,1924,0,19
128,23,New_Zealand,0,0,1,1,1924,0,4
129,23,Portugal,0,0,1,1,1924,0,28
130,23,Romania,0,0,1,1,1924,0,35
131,1,United_States,22,18,16,56,1928,0,268
132,2,Germany,10,7,14,31,1928,0,288
133,3,Finland,8,8,9,25,1928,0,69
134,4,Sweden,7,6,12,25,1928,0,90
135,5,Italy,7,5,7,19,1928,0,163
136,6,Switzerland,7,4,4,15,1928,0,133
137,7,France,6,10,5,21,1928,0,244
138,8,Netherlands,6,9,4,19,1928,1,255
139,9,Hungary,4,5,0,9,1928,0,104
140,10,Canada,4,4,7,15,1928,0,69
141,11,Great_Britain,3,10,7,20,1928,0,225
142,12,Argentina,3,3,1,7,1928,0,76
143,13,Denmark,3,1,2,6,1928,0,87
144,14,Czechoslovakia,2,5,2,9,1928,0,69
145,15,Japan,2,2,1,5,1928,0,40
146,16,Estonia,2,1,2,5,1928,0,15
147,17,Egypt,2,1,1,4,1928,0,32
148,18,Austria,2,0,1,3,1928,0,73
149,19,Australia,1,2,1,4,1928,0,18
150,19,Norway,1,2,1,4,1928,0,44
151,21,Poland,1,1,3,5,1928,0,93
152,21,Yugoslavia,1,1,3,5,1928,0,34
153,23,South_Africa,1,0,2,3,1928,0,24
154,24,India,1,0,0,1,1928,0,21
155,24,Ireland,1,0,0,1,1928,0,38
156,24,New_Zealand,1,0,0,1,1928,0,9
157,24,Spain,1,0,0,1,1928,0,75
158,24,Uruguay,1,0,0,1,1928,0,17
159,29,Belgium,0,1,2,3,1928,0,182
160,30,Chile,0,1,0,1,1928,0,38
161,30,Haiti,0,1,0,1,1928,0,2
162,32,Philippines,0,0,1,1,1928,0,4
163,32,Portugal,0,0,1,1,1928,0,27
164,1,United_States,44,36,30,110,1932,1,445
165,2,Italy,12,12,12,36,1932,0,112
166,3,France,11,5,4,20,1932,0,101
167,4,Sweden,10,5,9,24,1932,0,75
168,5,Japan,7,7,4,18,1932,0,157
169,6,Hungary,6,5,5,16,1932,0,58
170,7,Germany,5,12,7,24,1932,0,145
171,8,Finland,5,8,12,25,1932,0,40
172,9,Great_Britain,5,7,5,17,1932,0,106
173,10,Poland,3,2,4,9,1932,0,51
174,11,Australia,3,1,1,5,1932,0,13
175,12,Argentina,3,1,0,4,1932,0,33
176,13,Canada,2,5,9,16,1932,0,90
177,14,Netherlands,2,5,1,8,1932,0,45
178,15,South_Africa,2,0,3,5,1932,0,11
179,16,Ireland,2,0,0,2,1932,0,16
180,17,Czechoslovakia,1,3,2,6,1932,0,25
181,18,Austria,1,1,3,5,1932,0,19
182,19,India,1,0,0,1,1932,0,19
183,20,Denmark,0,5,3,8,1932,0,43
184,21,Mexico,0,2,0,2,1932,0,72
185,22,Latvia,0,1,0,1,1932,0,5
186,22,New_Zealand,0,1,0,1,1932,0,21
187,22,Switzerland,0,1,0,1,1932,0,7
188,25,Philippines,0,0,3,3,1932,0,8
189,26,Belgium,0,0,1,1,1932,0,36
190,26,Spain,0,0,1,1,1932,0,7
191,26,Uruguay,0,0,1,1,1932,0,2
192,1,Germany,38,31,32,101,1936,1,419
193,2,United_States,24,21,12,57,1936,0,340
194,3,Hungary,10,1,5,16,1936,0,215
195,4,Italy,9,13,5,27,1936,0,230
196,5,Finland,8,6,6,20,1936,0,96
197,6,France,7,6,6,19,1936,0,187
198,7,Sweden,6,5,10,21,1936,0,156
199,8,Japan,6,4,10,20,1936,0,217
200,9,Netherlands,6,4,7,17,1936,0,157
201,10,Austria,5,7,5,17,1936,0,233
202,11,Switzerland,4,9,5,18,1936,0,184
203,12,Great_Britain,4,7,3,14,1936,0,194
204,13,Czechoslovakia,3,5,1,9,1936,0,189
205,14,Argentina,2,2,3,7,1936,0,40
206,14,Estonia,2,2,3,7,1936,0,32
207,16,Egypt,2,1,2,5,1936,0,53
208,17,Canada,1,3,5,9,1936,0,96
209,18,Norway,1,3,2,6,1936,0,56
210,19,Turkey,1,0,1,2,1936,0,45
211,20,India,1,0,0,1,1936,0,27
212,20,New_Zealand,1,0,0,1,1936,0,7
213,22,Poland,0,4,5,9,1936,0,139
214,23,Denmark,0,2,3,5,1936,0,114
215,24,Latvia,0,1,1,2,1936,0,29
216,25,Romania,0,1,0,1,1936,0,54
217,25,South_Africa,0,1,0,1,1936,0,32
218,25,Yugoslavia,0,1,0,1,1936,0,92
219,28,Belgium,0,0,3,3,1936,0,147
220,28,Mexico,0,0,3,3,1936,0,32
221,30,Australia,0,0,1,1,1936,0,32
222,30,Philippines,0,0,1,1,1936,0,28
223,30,Portugal,0,0,1,1,1936,0,16
224,1,United_States,38,27,19,84,1948,0,279
225,2,Sweden,16,11,17,44,1948,0,168
226,3,France,10,6,13,29,1948,0,304
227,4,Hungary,10,5,12,27,1948,0,128
228,5,Italy,8,11,8,27,1948,0,201
229,6,Finland,8,7,5,20,1948,0,118
230,7,Turkey,6,4,2,12,1948,0,58
231,8,Czechoslovakia,6,2,3,11,1948,0,87
232,9,Switzerland,5,10,5,20,1948,0,178
233,10,Denmark,5,7,8,20,1948,0,152
234,11,Netherlands,5,2,9,16,1948,0,142
235,12,Great_Britain,3,14,6,23,1948,1,395
236,13,Argentina,3,3,1,7,1948,0,187
237,14,Australia,2,6,5,13,1948,0,73
238,15,Belgium,2,2,3,7,1948,0,140
239,16,Egypt,2,2,1,5,1948,0,85
240,17,Mexico,2,1,2,5,1948,0,88
241,18,South_Africa,2,1,1,4,1948,0,35
242,19,Norway,1,3,3,7,1948,0,71
243,20,Jamaica,1,2,0,3,1948,0,13
244,21,Austria,1,0,3,4,1948,0,145
245,22,India,1,0,0,1,1948,0,79
246,22,Peru,1,0,0,1,1948,0,41
247,24,Yugoslavia,0,2,0,2,1948,0,90
248,25,Canada,0,1,2,3,1948,0,123
249,26,Portugal,0,1,1,2,1948,0,40
250,26,Uruguay,0,1,1,2,1948,0,59
251,28,Ceylon,0,1,0,1,1948,0,59
252,28,Cuba,0,1,0,1,1948,0,51
253,28,Spain,0,1,0,1,1948,0,62
254,28,Trinidad_and_Tobago,0,1,0,1,1948,0,5
255,32,Panama,0,0,2,2,1948,0,1
256,32,South_Korea,0,0,2,2,1948,0,46
257,34,Brazil,0,0,1,1,1948,0,66
258,34,Iran,0,0,1,1,1948,0,36
259,34,Poland,0,0,1,1,1948,0,38
260,34,Puerto_Rico,0,0,1,1,1948,0,9
261,1,United_States,40,19,17,76,1952,0,264
262,2,Soviet_Union,22,30,19,71,1952,0,287
263,3,Hungary,16,10,16,42,1952,0,188
264,4,Sweden,12,13,10,35,1952,0,192
265,5,Italy,8,9,4,21,1952,0,218
266,6,Czechoslovakia,7,3,3,13,1952,0,99
267,7,France,6,6,6,18,1952,0,237
268,8,Finland,6,3,13,22,1952,1,245
269,9,Australia,6,2,3,11,1952,0,76
270,10,Norway,3,2,0,5,1952,0,91
271,11,Switzerland,2,6,6,14,1952,0,147
272,12,South_Africa,2,4,4,10,1952,0,61
273,13,Jamaica,2,3,0,5,1952,0,8
274,14,Belgium,2,2,0,4,1952,0,131
275,15,Denmark,2,1,3,6,1952,0,122
276,16,Turkey,2,0,1,3,1952,0,51
277,17,Japan,1,6,2,9,1952,0,69
278,18,Great_Britain,1,2,8,11,1952,0,243
279,19,Argentina,1,2,2,5,1952,0,110
280,20,Poland,1,2,1,4,1952,0,125
281,21,Canada,1,2,0,3,1952,0,97
282,21,Yugoslavia,1,2,0,3,1952,0,85
283,23,Romania,1,1,2,4,1952,0,114
284,24,Brazil,1,0,2,3,1952,0,92
285,24,New_Zealand,1,0,2,3,1952,0,14
286,26,India,1,0,1,2,1952,0,64
287,27,Luxembourg,1,0,0,1,1952,0,44
288,28,Germany,0,7,17,24,1952,0,192
289,29,Netherlands,0,5,0,5,1952,0,96
290,30,Iran,0,3,4,7,1952,0,22
291,31,Chile,0,2,0,2,1952,0,59
292,32,Austria,0,1,1,2,1952,0,110
293,32,Lebanon,0,1,1,2,1952,0,9
294,34,Ireland,0,1,0,1,1952,0,19
295,34,Mexico,0,1,0,1,1952,0,64
296,34,Spain,0,1,0,1,1952,0,27
297,37,South_Korea,0,0,2,2,1952,0,19
298,37,Trinidad_and_Tobago,0,0,2,2,1952,0,2
299,37,Uruguay,0,0,2,2,1952,0,32
300,40,Bulgaria,0,0,1,1,1952,0,63
301,40,Egypt,0,0,1,1,1952,0,106
302,40,Portugal,0,0,1,1,1952,0,63
303,40,Venezuela,0,0,1,1,1952,0,38
304,1,Soviet_Union,37,29,32,98,1956,0,271
305,2,United_States,32,25,17,74,1956,0,289
306,3,Australia,13,8,14,35,1956,1,288
307,4,Hungary,9,10,7,26,1956,0,111
308,5,Italy,8,8,9,25,1956,0,124
309,6,Sweden,8,5,6,19,1956,0,91
310,7,United_Team_of_Germany,6,13,7,26,1956,0,91
311,8,Great_Britain,6,7,11,24,1956,0,186
312,9,Romania,5,3,5,13,1956,0,50
313,10,Japan,4,10,5,19,1956,0,112
314,11,France,4,4,6,14,1956,0,138
315,12,Turkey,3,2,2,7,1956,0,19
316,13,Finland,3,1,11,15,1956,0,68
317,14,Iran,2,2,1,5,1956,0,17
318,15,Canada,2,1,3,6,1956,0,89
319,16,New_Zealand,2,0,0,2,1956,0,46
320,17,Poland,1,4,4,9,1956,0,64
321,18,Czechoslovakia,1,4,1,6,1956,0,63
322,19,Bulgaria,1,3,1,5,1956,0,46
323,20,Denmark,1,2,1,4,1956,0,34
324,21,Ireland,1,1,3,5,1956,0,18
325,22,Norway,1,0,2,3,1956,0,16
326,23,Mexico,1,0,1,2,1956,0,24
327,24,Brazil,1,0,0,1,1956,0,45
328,24,India,1,0,0,1,1956,0,58
329,26,Yugoslavia,0,3,0,3,1956,0,35
330,27,Chile,0,2,2,4,1956,0,33
331,28,Belgium,0,2,0,2,1956,0,57
332,29,Argentina,0,1,1,2,1956,0,30
333,29,South_Korea,0,1,1,2,1956,0,35
334,31,Iceland,0,1,0,1,1956,0,2
335,31,Pakistan,0,1,0,1,1956,0,53
336,33,South_Africa,0,0,4,4,1956,0,45
337,34,Austria,0,0,2,2,1956,0,34
338,35,Bahamas,0,0,1,1,1956,0,2
339,35,Greece,0,0,1,1,1956,0,11
340,35,Switzerland,0,0,1,1,1956,0,9
341,35,Uruguay,0,0,1,1,1956,0,21
342,1,Soviet_Union,43,29,31,103,1960,0,273
343,2,United_States,34,21,16,71,1960,0,279
344,3,Italy,13,10,13,36,1960,1,270
345,4,United_Team_of_Germany,12,19,11,42,1960,0,270
346,5,Australia,8,8,6,22,1960,0,179
347,6,Turkey,7,2,0,9,1960,0,49
348,7,Hungary,6,8,7,21,1960,0,179
349,8,Japan,4,7,7,18,1960,0,156
350,9,Poland,4,6,11,21,1960,0,185
351,10,Czechoslovakia,3,2,3,8,1960,0,116
352,11,Romania,3,1,6,10,1960,0,98
353,12,Great_Britain,2,6,12,20,1960,0,243
354,13,Denmark,2,3,1,6,1960,0,91
355,14,New_Zealand,2,0,1,3,1960,0,35
356,15,Bulgaria,1,3,3,7,1960,0,97
357,16,Sweden,1,2,3,6,1960,0,123
358,17,Finland,1,1,3,5,1960,0,109
359,18,Austria,1,1,0,2,1960,0,96
360,18,Yugoslavia,1,1,0,2,1960,0,114
361,20,Pakistan,1,0,1,2,1960,0,43
362,21,Ethiopia,1,0,0,1,1960,0,10
363,21,Greece,1,0,0,1,1960,0,41
364,21,Norway,1,0,0,1,1960,0,32
365,24,Switzerland,0,3,3,6,1960,0,139
366,25,France,0,2,3,5,1960,0,228
367,26,Belgium,0,2,2,4,1960,0,98
368,27,Iran,0,1,3,4,1960,0,23
369,28,Netherlands,0,1,2,3,1960,0,104
370,28,South_Africa,0,1,2,3,1960,0,53
371,30,Argentina,0,1,1,2,1960,0,84
372,30,Egypt,0,1,1,2,1960,0,84
373,32,Canada,0,1,0,1,1960,0,75
374,32,Formosa,0,1,0,1,1960,0,75
375,32,Ghana,0,1,0,1,1960,0,13
376,32,India,0,1,0,1,1960,0,45
377,32,Morocco,0,1,0,1,1960,0,47
378,32,Portugal,0,1,0,1,1960,0,55
379,32,Singapore,0,1,0,1,1960,0,2
380,39,Brazil,0,0,2,2,1960,0,68
381,39,British_West_Indies,0,0,2,2,1960,0,68
382,41,Iraq,0,0,1,1,1960,0,21
383,41,Mexico,0,0,1,1,1960,0,67
384,41,Spain,0,0,1,1,1960,0,133
385,41,Venezuela,0,0,1,1,1960,0,34
386,1,United_States,36,26,28,90,1964,0,334
387,2,Soviet_Union,30,31,35,96,1964,0,306
388,3,Japan,16,5,8,29,1964,1,318
389,4,United_Team_of_Germany,10,22,18,50,1964,0,318
390,5,Italy,10,10,7,27,1964,0,157
391,6,Hungary,10,7,5,22,1964,0,182
392,7,Poland,7,6,10,23,1964,0,139
393,8,Australia,6,2,10,18,1964,0,233
394,9,Czechoslovakia,5,6,3,14,1964,0,104
395,10,Great_Britain,4,12,2,18,1964,0,196
396,11,Bulgaria,3,5,2,10,1964,0,63
397,12,Finland,3,0,2,5,1964,0,84
398,12,New_Zealand,3,0,2,5,1964,0,61
399,14,Romania,2,4,6,12,1964,0,138
400,15,Netherlands,2,4,4,10,1964,0,119
401,16,Turkey,2,3,1,6,1964,0,23
402,17,Sweden,2,2,4,8,1964,0,84
403,18,Denmark,2,1,3,6,1964,0,52
404,19,Yugoslavia,2,1,2,5,1964,0,75
405,20,Belgium,2,0,1,3,1964,0,61
406,21,France,1,8,6,15,1964,0,136
407,22,Canada,1,2,1,4,1964,0,105
408,22,Switzerland,1,2,1,4,1964,0,59
409,24,Bahamas,1,0,0,1,1964,0,3
410,24,Ethiopia,1,0,0,1,1964,0,12
411,24,India,1,0,0,1,1964,0,52
412,27,South_Korea,0,2,1,3,1964,0,153
413,28,Trinidad_and_Tobago,0,1,2,3,1964,0,11
414,29,Tunisia,0,1,1,2,1964,0,9
415,30,Argentina,0,1,0,1,1964,0,97
416,30,Cuba,0,1,0,1,1964,0,27
417,30,Pakistan,0,1,0,1,1964,0,41
418,30,Philippines,0,1,0,1,1964,0,44
419,34,Iran,0,0,2,2,1964,0,62
420,35,Brazil,0,0,1,1,1964,0,57
421,35,Ghana,0,0,1,1,1964,0,33
422,35,Ireland,0,0,1,1,1964,0,22
423,35,Kenya,0,0,1,1,1964,0,37
424,35,Mexico,0,0,1,1,1964,0,83
425,35,Nigeria,0,0,1,1,1964,0,18
426,35,Uruguay,0,0,1,1,1964,0,23
427,1,United_States,45,28,34,107,1968,0,355
428,2,Soviet_Union,29,32,30,91,1968,0,311
429,3,Japan,11,7,7,25,1968,0,171
430,4,Hungary,10,10,12,32,1968,0,166
431,5,East_Germany,9,9,7,25,1968,0,225
432,6,France,7,3,5,15,1968,0,200
433,7,Czechoslovakia,7,2,4,13,1968,0,121
434,8,West_Germany,5,11,10,26,1968,0,275
435,9,Australia,5,7,5,17,1968,0,128
436,10,Great_Britain,5,5,3,13,1968,0,225
437,11,Poland,5,2,11,18,1968,0,177
438,12,Romania,4,6,5,15,1968,0,82
439,13,Italy,3,4,9,16,1968,0,167
440,14,Kenya,3,4,2,9,1968,0,39
441,15,Mexico,3,3,3,9,1968,1,272
442,16,Yugoslavia,3,3,2,8,1968,0,69
443,17,Netherlands,3,3,1,7,1968,0,107
444,18,Bulgaria,2,4,3,9,1968,0,112
445,19,Iran,2,1,2,5,1968,0,14
446,20,Sweden,2,1,1,4,1968,0,100
447,21,Turkey,2,0,0,2,1968,0,29
448,22,Denmark,1,4,3,8,1968,0,62
449,23,Canada,1,3,1,5,1968,0,139
450,24,Finland,1,2,1,4,1968,0,66
451,25,Ethiopia,1,1,0,2,1968,0,18
452,25,Norway,1,1,0,2,1968,0,46
453,27,New_Zealand,1,0,2,3,1968,0,52
454,28,Tunisia,1,0,1,2,1968,0,7
455,29,Pakistan,1,0,0,1,1968,0,15
456,29,Venezuela,1,0,0,1,1968,0,23
457,31,Cuba,0,4,0,4,1968,0,115
458,32,Austria,0,2,2,4,1968,0,43
459,33,Switzerland,0,1,4,5,1968,0,85
460,34,Mongolia,0,1,3,4,1968,0,16
461,35,Brazil,0,1,2,3,1968,0,75
462,36,Belgium,0,1,1,2,1968,0,82
463,36,South_Korea,0,1,1,2,1968,0,54
464,36,Uganda,0,1,1,2,1968,0,11
465,39,Cameroon,0,1,0,1,1968,0,5
466,39,Jamaica,0,1,0,1,1968,0,25
467,41,Argentina,0,0,2,2,1968,0,89
468,42,Greece,0,0,1,1,1968,0,44
469,42,India,0,0,1,1,1968,0,23
470,42,Taiwan,0,0,1,1,1968,0,23
471,1,Soviet_Union,50,27,22,99,1972,0,371
472,2,United_States,33,31,30,94,1972,0,393
473,3,East_Germany,20,23,23,66,1972,0,291
474,4,West_Germany,13,11,16,40,1972,1,418
475,5,Japan,13,8,8,29,1972,0,184
476,6,Australia,8,7,2,17,1972,0,168
477,7,Poland,7,5,9,21,1972,0,284
478,8,Hungary,6,13,16,35,1972,0,226
479,9,Bulgaria,6,10,5,21,1972,0,129
480,10,Italy,5,3,10,18,1972,0,223
481,11,Sweden,4,6,6,16,1972,0,131
482,12,Great_Britain,4,5,9,18,1972,0,280
483,13,Romania,3,6,7,16,1972,0,159
484,14,Cuba,3,1,4,8,1972,0,137
485,14,Finland,3,1,4,8,1972,0,96
486,16,Netherlands,3,1,1,5,1972,0,119
487,17,France,2,4,7,13,1972,0,227
488,18,Czechoslovakia,2,4,2,8,1972,0,175
489,19,Kenya,2,3,4,9,1972,0,57
490,20,Yugoslavia,2,1,2,5,1972,0,122
491,21,Norway,2,1,1,4,1972,0,112
492,22,North_Korea,1,1,3,5,1972,0,37
493,23,New_Zealand,1,1,1,3,1972,0,89
494,24,Uganda,1,1,0,2,1972,0,33
495,25,Denmark,1,0,0,1,1972,0,126
496,26,Switzerland,0,3,0,3,1972,0,151
497,27,Canada,0,2,3,5,1972,0,207
498,28,Iran,0,2,1,3,1972,0,48
499,29,Belgium,0,2,0,2,1972,0,88
500,29,Greece,0,2,0,2,1972,0,60
501,31,Austria,0,1,2,3,1972,0,111
502,31,Colombia,0,1,2,3,1972,0,59
503,33,Argentina,0,1,0,1,1972,0,92
504,33,Lebanon,0,1,0,1,1972,0,19
505,33,Mexico,0,1,0,1,1972,0,171
506,33,Mongolia,0,1,0,1,1972,0,39
507,33,Pakistan,0,1,0,1,1972,0,24
508,33,South_Korea,0,1,0,1,1972,0,42
509,33,Tunisia,0,1,0,1,1972,0,35
510,33,Turkey,0,1,0,1,1972,0,43
511,41,Brazil,0,0,2,2,1972,0,80
512,41,Ethiopia,0,0,2,2,1972,0,31
513,43,Ghana,0,0,1,1,1972,0,35
514,43,India,0,0,1,1,1972,0,41
515,43,Jamaica,0,0,1,1,1972,0,32
516,43,Niger,0,0,1,1,1972,0,4
517,43,Nigeria,0,0,1,1,1972,0,25
518,43,Spain,0,0,1,1,1972,0,122
519,1,Soviet_Union,49,41,35,125,1976,0,408
520,2,East_Germany,40,25,25,90,1976,0,267
521,3,United_States,34,35,25,94,1976,0,391
522,4,West_Germany,10,12,17,39,1976,0,290
523,5,Japan,9,6,10,25,1976,0,213
524,6,Poland,7,6,13,26,1976,0,207
525,7,Bulgaria,6,9,7,22,1976,0,155
526,8,Cuba,6,4,3,13,1976,0,156
527,9,Romania,4,9,14,27,1976,0,157
528,10,Hungary,4,5,13,22,1976,0,177
529,11,Finland,4,2,0,6,1976,0,83
530,12,Sweden,4,1,0,5,1976,0,116
531,13,Great_Britain,3,5,5,13,1976,0,242
532,14,Italy,2,7,4,13,1976,0,209
533,15,France,2,3,4,9,1976,0,206
534,16,Yugoslavia,2,3,3,8,1976,0,88
535,17,Czechoslovakia,2,2,4,8,1976,0,163
536,18,New_Zealand,2,1,1,4,1976,0,80
537,19,South_Korea,1,1,4,6,1976,0,50
538,20,Switzerland,1,1,2,4,1976,0,50
539,21,Jamaica,1,1,0,2,1976,0,20
540,21,North_Korea,1,1,0,2,1976,0,38
541,21,Norway,1,1,0,2,1976,0,66
542,24,Denmark,1,0,2,3,1976,0,66
543,25,Mexico,1,0,1,2,1976,0,96
544,26,Trinidad_and_Tobago,1,0,0,1,1976,0,13
545,27,Canada,0,5,6,11,1976,1,385
546,28,Belgium,0,3,3,6,1976,0,101
547,29,Netherlands,0,2,3,5,1976,0,108
548,30,Portugal,0,2,0,2,1976,0,19
549,30,Spain,0,2,0,2,1976,0,113
550,32,Australia,0,1,4,5,1976,0,180
551,33,Iran,0,1,1,2,1976,0,84
552,34,Mongolia,0,1,0,1,1976,0,32
553,34,Venezuela,0,1,0,1,1976,0,32
554,36,Brazil,0,0,2,2,1976,0,79
555,37,Austria,0,0,1,1,1976,0,60
556,37,Bermuda,0,0,1,1,1976,0,16
557,37,Pakistan,0,0,1,1,1976,0,24
558,37,Puerto_Rico,0,0,1,1,1976,0,80
559,37,Thailand,0,0,1,1,1976,0,42
560,1,Soviet_Union,80,69,46,195,1980,1,489
561,2,East_Germany,47,37,42,126,1980,0,346
562,3,Bulgaria,8,16,17,41,1980,0,270
563,4,Cuba,8,7,5,20,1980,0,203
564,5,Italy,8,3,4,15,1980,0,159
565,6,Hungary,7,10,15,32,1980,0,260
566,7,Romania,6,6,13,25,1980,0,226
567,8,France,6,5,3,14,1980,0,121
568,9,Great_Britain,5,7,9,21,1980,0,219
569,10,Poland,3,14,15,32,1980,0,305
570,11,Sweden,3,3,6,12,1980,0,144
571,12,Finland,3,1,4,8,1980,0,105
572,13,Czechoslovakia,2,3,9,14,1980,0,209
573,14,Yugoslavia,2,3,4,9,1980,0,164
574,15,Australia,2,2,5,9,1980,0,120
575,16,Denmark,2,1,2,5,1980,0,58
576,17,Brazil,2,0,2,4,1980,0,106
577,17,Ethiopia,2,0,2,4,1980,0,41
578,19,Switzerland,2,0,0,2,1980,0,73
579,20,Spain,1,3,2,6,1980,0,155
580,21,Austria,1,2,1,4,1980,0,83
581,22,Greece,1,0,2,3,1980,0,41
582,23,Belgium,1,0,0,1,1980,0,59
583,23,India,1,0,0,1,1980,0,71
584,23,Zimbabwe,1,0,0,1,1980,0,42
585,26,North_Korea,0,3,2,5,1980,0,47
586,27,Mongolia,0,2,2,4,1980,0,43
587,28,Tanzania,0,2,0,2,1980,0,41
588,29,Mexico,0,1,3,4,1980,0,45
589,30,Netherlands,0,1,2,3,1980,0,75
590,31,Ireland,0,1,1,2,1980,0,47
591,32,Uganda,0,1,0,1,1980,0,13
592,32,Venezuela,0,1,0,1,1980,0,37
593,34,Jamaica,0,0,3,3,1980,0,18
594,35,Guyana,0,0,1,1,1980,0,8
595,35,Lebanon,0,0,1,1,1980,0,15
596,1,United_States,83,61,30,174,1984,1,519
597,2,Romania,20,16,17,53,1984,0,124
598,3,West_Germany,17,19,23,59,1984,0,389
599,4,China,15,8,9,32,1984,0,215
600,5,Italy,14,6,12,32,1984,0,268
601,6,Canada,10,18,16,44,1984,0,408
602,7,Japan,10,8,14,32,1984,0,226
603,8,New_Zealand,8,1,2,11,1984,0,130
604,9,Yugoslavia,7,4,7,18,1984,0,139
605,10,South_Korea,6,6,7,19,1984,0,174
606,11,Great_Britain,5,11,21,37,1984,0,337
607,12,France,5,7,16,28,1984,0,238
608,13,Netherlands,5,2,6,13,1984,0,135
609,14,Australia,4,8,12,24,1984,0,242
610,15,Finland,4,2,6,12,1984,0,86
611,16,Sweden,2,11,6,19,1984,0,172
612,17,Mexico,2,3,1,6,1984,0,98
613,18,Morocco,2,0,0,2,1984,0,34
614,19,Brazil,1,5,2,8,1984,0,147
615,20,Spain,1,2,2,5,1984,0,179
616,21,Belgium,1,1,2,4,1984,0,63
617,22,Austria,1,1,1,3,1984,0,102
618,23,Kenya,1,0,2,3,1984,0,61
619,23,Portugal,1,0,2,3,1984,0,38
620,25,Pakistan,1,0,0,1,1984,0,31
621,26,Switzerland,0,4,4,8,1984,0,129
622,27,Denmark,0,3,3,6,1984,0,60
623,28,Jamaica,0,1,2,3,1984,0,45
624,28,Norway,0,1,2,3,1984,0,103
625,30,Greece,0,1,1,2,1984,0,63
626,30,Nigeria,0,1,1,2,1984,0,32
627,30,Puerto_Rico,0,1,1,2,1984,0,51
628,33,Colombia,0,1,0,1,1984,0,39
629,33,Egypt,0,1,0,1,1984,0,113
630,33,Ireland,0,1,0,1,1984,0,42
631,33,Ivory_Coast,0,1,0,1,1984,0,42
632,33,Peru,0,1,0,1,1984,0,35
633,33,Syria,0,1,0,1,1984,0,9
634,33,Thailand,0,1,0,1,1984,0,35
635,40,Turkey,0,0,3,3,1984,0,46
636,40,Venezuela,0,0,3,3,1984,0,26
637,42,Algeria,0,0,2,2,1984,0,33
638,43,Cameroon,0,0,1,1,1984,0,46
639,43,Chinese_Taipei,0,0,1,1,1984,0,38
640,43,Dominican_Republic,0,0,1,1,1984,0,19
641,43,Iceland,0,0,1,1,1984,0,30
642,43,Zambia,0,0,1,1,1984,0,16
643,1,Soviet_Union,55,31,46,132,1988,0,479
644,2,East_Germany,37,35,30,102,1988,0,259
645,3,United_States,36,31,27,94,1988,0,526
646,4,South_Korea,12,10,11,33,1988,1,398
647,5,West_Germany,11,14,15,40,1988,0,345
648,6,Hungary,11,6,6,23,1988,0,188
649,7,Bulgaria,10,12,13,35,1988,0,172
650,8,Romania,7,11,6,24,1988,0,68
651,9,France,6,4,6,16,1988,0,266
652,10,Italy,6,4,4,14,1988,0,253
653,11,China,5,11,12,28,1988,0,270
654,12,Great_Britain,5,10,9,24,1988,0,344
655,13,Kenya,5,2,2,9,1988,0,74
656,14,Japan,4,3,7,14,1988,0,254
657,15,Australia,3,6,5,14,1988,0,252
658,16,Yugoslavia,3,4,5,12,1988,0,155
659,17,Czechoslovakia,3,3,2,8,1988,0,163
660,18,New_Zealand,3,2,8,13,1988,0,83
661,19,Canada,3,2,5,10,1988,0,328
662,20,Poland,2,5,9,16,1988,0,143
663,21,Norway,2,3,0,5,1988,0,69
664,22,Netherlands,2,2,5,9,1988,0,147
665,23,Denmark,2,1,1,4,1988,0,78
666,24,Brazil,1,2,3,6,1988,0,157
667,25,Finland,1,1,2,4,1988,0,78
668,25,Spain,1,1,2,4,1988,0,226
669,27,Turkey,1,1,0,2,1988,0,41
670,28,Morocco,1,0,2,3,1988,0,27
671,29,Austria,1,0,0,1,1988,0,73
672,29,Portugal,1,0,0,1,1988,0,65
673,29,Suriname,1,0,0,1,1988,0,6
674,32,Sweden,0,4,7,11,1988,0,181
675,33,Switzerland,0,2,2,4,1988,0,99
676,34,Jamaica,0,2,0,2,1988,0,35
677,35,Argentina,0,1,1,2,1988,0,118
678,36,Chile,0,1,0,1,1988,0,17
679,36,Costa_Rica,0,1,0,1,1988,0,16
680,36,Indonesia,0,1,0,1,1988,0,29
681,36,Iran,0,1,0,1,1988,0,23
682,36,Netherlands_Antilles,0,1,0,1,1988,0,3
683,36,Peru,0,1,0,1,1988,0,21
684,36,Senegal,0,1,0,1,1988,0,23
685,36,Virgin_Islands,0,1,0,1,1988,0,23
686,44,Belgium,0,0,2,2,1988,0,59
687,44,Mexico,0,0,2,2,1988,0,81
688,46,Colombia,0,0,1,1,1988,0,40
689,46,Djibouti,0,0,1,1,1988,0,6
690,46,Greece,0,0,1,1,1988,0,56
691,46,Mongolia,0,0,1,1,1988,0,28
692,46,Pakistan,0,0,1,1,1988,0,30
693,46,Philippines,0,0,1,1,1988,0,31
694,46,Thailand,0,0,1,1,1988,0,14
695,1,Unified_Team,45,38,29,112,1992,0,473
696,2,United_States,37,34,37,108,1992,0,534
697,3,Germany,33,21,28,82,1992,0,457
698,4,China,16,22,16,54,1992,0,233
699,5,Cuba,14,6,11,31,1992,0,176
700,6,Spain,13,7,2,22,1992,1,412
701,7,South_Korea,12,5,12,29,1992,0,215
702,8,Hungary,11,12,7,30,1992,0,215
703,9,France,8,5,16,29,1992,0,331
704,10,Australia,7,9,11,27,1992,0,278
705,11,Canada,7,4,7,18,1992,0,294
706,12,Italy,6,5,8,19,1992,0,304
707,13,Great_Britain,5,3,12,20,1992,0,359
708,14,Romania,4,6,8,18,1992,0,171
709,15,Czechoslovakia,4,2,1,7,1992,0,202
710,16,North_Korea,4,0,5,9,1992,0,62
711,17,Japan,3,8,11,22,1992,0,247
712,18,Bulgaria,3,7,6,16,1992,0,134
713,19,Poland,3,6,10,19,1992,0,199
714,20,Netherlands,2,6,7,15,1992,0,201
715,21,Kenya,2,4,2,8,1992,0,49
716,22,Norway,2,4,1,7,1992,0,83
717,23,Turkey,2,2,2,6,1992,0,41
718,24,Indonesia,2,2,1,5,1992,0,34
719,25,Brazil,2,1,0,3,1992,0,181
720,26,Greece,2,0,0,2,1992,0,70
721,27,Sweden,1,7,4,12,1992,0,182
722,28,New_Zealand,1,4,5,10,1992,0,134
723,29,Finland,1,2,2,5,1992,0,87
724,30,Denmark,1,1,4,6,1992,0,101
725,31,Morocco,1,1,1,3,1992,0,44
726,32,Ireland,1,1,0,2,1992,0,58
727,33,Ethiopia,1,0,2,3,1992,0,20
728,34,Algeria,1,0,1,2,1992,0,35
729,34,Estonia,1,0,1,2,1992,0,37
730,34,Lithuania,1,0,1,2,1992,0,47
731,37,Switzerland,1,0,0,1,1992,0,102
732,38,Jamaica,0,3,1,4,1992,0,36
733,38,Nigeria,0,3,1,4,1992,0,54
734,40,Latvia,0,2,1,3,1992,0,34
735,41,Austria,0,2,0,2,1992,0,102
736,41,Namibia,0,2,0,2,1992,0,6
737,41,South_Africa,0,2,0,2,1992,0,93
738,44,Belgium,0,1,2,3,1992,0,68
739,44,Croatia,0,1,2,3,1992,0,39
740,44,Independent_Olympic_Participants,0,1,2,3,1992,0,39
741,44,Iran,0,1,2,3,1992,0,36
742,48,Israel,0,1,1,2,1992,0,30
743,49,Chinese_Taipei,0,1,0,1,1992,0,31
744,49,Mexico,0,1,0,1,1992,0,102
745,49,Peru,0,1,0,1,1992,0,16
746,52,Mongolia,0,0,2,2,1992,0,33
747,52,Slovenia,0,0,2,2,1992,0,35
748,54,Argentina,0,0,1,1,1992,0,84
749,54,Bahamas,0,0,1,1,1992,0,14
750,54,Colombia,0,0,1,1,1992,0,49
751,54,Ghana,0,0,1,1,1992,0,34
752,54,Malaysia,0,0,1,1,1992,0,22
753,54,Pakistan,0,0,1,1,1992,0,27
754,54,Philippines,0,0,1,1,1992,0,26
755,54,Puerto_Rico,0,0,1,1,1992,0,69
756,54,Qatar,0,0,1,1,1992,0,28
757,54,Suriname,0,0,1,1,1992,0,6
758,54,Thailand,0,0,1,1,1992,0,46
759,1,United_States,44,32,25,101,1996,1,635
760,2,Russia,26,21,16,63,1996,0,389
761,3,Germany,20,18,27,65,1996,0,459
762,4,China,16,22,12,50,1996,0,277
763,5,France,15,7,15,37,1996,0,293
764,6,Italy,13,10,12,35,1996,0,340
765,7,Australia,9,9,23,41,1996,0,412
766,8,Cuba,9,8,8,25,1996,0,164
767,9,Ukraine,9,2,12,23,1996,0,231
768,10,South_Korea,7,15,5,27,1996,0,288
769,11,Poland,7,5,5,17,1996,0,161
770,12,Hungary,7,4,10,21,1996,0,212
771,13,Spain,5,6,6,17,1996,0,280
772,14,Romania,4,7,9,20,1996,0,165
773,15,Netherlands,4,5,10,19,1996,0,237
774,16,Greece,4,4,0,8,1996,0,121
775,17,Czech_Republic,4,3,4,11,1996,0,111
776,18,Switzerland,4,3,0,7,1996,0,115
777,19,Denmark,4,1,1,6,1996,0,112
778,19,Turkey,4,1,1,6,1996,0,53
779,21,Canada,3,11,8,22,1996,0,298
780,22,Bulgaria,3,7,5,15,1996,0,108
781,23,Japan,3,6,5,14,1996,0,296
782,24,Kazakhstan,3,4,4,11,1996,0,96
783,25,Brazil,3,3,9,15,1996,0,212
784,26,New_Zealand,3,2,1,6,1996,0,95
785,27,South_Africa,3,1,1,5,1996,0,84
786,28,Ireland,3,0,1,4,1996,0,78
787,29,Sweden,2,4,2,8,1996,0,174
788,30,Norway,2,2,3,7,1996,0,97
789,31,Belgium,2,2,2,6,1996,0,61
790,32,Nigeria,2,1,3,6,1996,0,65
791,33,North_Korea,2,1,2,5,1996,0,23
792,34,Algeria,2,0,1,3,1996,0,45
793,34,Ethiopia,2,0,1,3,1996,0,18
794,36,Great_Britain,1,8,6,15,1996,0,298
795,37,Belarus,1,6,8,15,1996,0,157
796,38,Kenya,1,4,3,8,1996,0,52
797,39,Jamaica,1,3,2,6,1996,0,46
798,40,Finland,1,2,1,4,1996,0,76
799,41,FR_Yugoslavia,1,1,2,4,1996,0,76
800,41,Indonesia,1,1,2,4,1996,0,28
801,43,Iran,1,1,1,3,1996,0,18
802,43,Slovakia,1,1,1,3,1996,0,67
803,45,Armenia,1,1,0,2,1996,0,32
804,45,Croatia,1,1,0,2,1996,0,84
805,47,Portugal,1,0,1,2,1996,0,106
806,47,Thailand,1,0,1,2,1996,0,33
807,49,Burundi,1,0,0,1,1996,0,7
808,49,Costa_Rica,1,0,0,1,1996,0,11
809,49,Ecuador,1,0,0,1,1996,0,19
810,49,Hong_Kong,1,0,0,1,1996,0,22
811,49,Syria,1,0,0,1,1996,0,7
812,54,Argentina,0,2,1,3,1996,0,179
813,55,Namibia,0,2,0,2,1996,0,8
814,55,Slovenia,0,2,0,2,1996,0,37
815,57,Austria,0,1,2,3,1996,0,70
816,58,Malaysia,0,1,1,2,1996,0,31
817,58,Moldova,0,1,1,2,1996,0,40
818,58,Uzbekistan,0,1,1,2,1996,0,71
819,61,Azerbaijan,0,1,0,1,1996,0,23
820,61,Bahamas,0,1,0,1,1996,0,26
821,61,Chinese_Taipei,0,1,0,1,1996,0,73
822,61,Latvia,0,1,0,1,1996,0,47
823,61,Philippines,0,1,0,1,1996,0,12
824,61,Tonga,0,1,0,1,1996,0,5
825,61,Zambia,0,1,0,1,1996,0,8
826,68,Georgia,0,0,2,2,1996,0,34
827,68,Morocco,0,0,2,2,1996,0,34
828,68,Trinidad_and_Tobago,0,0,2,2,1996,0,12
829,71,India,0,0,1,1,1996,0,49
830,71,Israel,0,0,1,1,1996,0,25
831,71,Lithuania,0,0,1,1,1996,0,61
832,71,Mexico,0,0,1,1,1996,0,97
833,71,Mongolia,0,0,1,1,1996,0,16
834,71,Mozambique,0,0,1,1,1996,0,3
835,71,Puerto_Rico,0,0,1,1,1996,0,69
836,71,Tunisia,0,0,1,1,1996,0,51
837,71,Uganda,0,0,1,1,1996,0,10
838,1,United_States,37,24,32,93,2000,0,575
839,2,Russia,32,28,29,89,2000,0,434
840,3,China,28,16,14,58,2000,0,252
841,4,Australia,16,25,17,58,2000,1,603
842,5,Germany,13,17,26,56,2000,0,410
843,6,France,13,14,11,38,2000,0,335
844,7,Italy,13,8,13,34,2000,0,357
845,8,Netherlands,12,9,4,25,2000,0,231
846,9,Cuba,11,11,7,29,2000,0,229
847,10,Great_Britain,11,10,7,28,2000,0,301
848,11,Romania,11,6,9,26,2000,0,145
849,12,South_Korea,8,10,10,28,2000,0,271
850,13,Hungary,8,6,3,17,2000,0,178
851,14,Poland,6,5,3,14,2000,0,183
852,15,Japan,5,8,5,18,2000,0,255
853,16,Bulgaria,5,6,2,13,2000,0,91
854,17,Greece,4,6,3,13,2000,0,140
855,18,Sweden,4,5,3,12,2000,0,149
856,19,Norway,4,3,3,10,2000,0,89
857,20,Ethiopia,4,1,3,8,2000,0,26
858,21,Ukraine,3,10,10,23,2000,0,230
859,22,Kazakhstan,3,4,0,7,2000,0,130
860,23,Belarus,3,3,11,17,2000,0,139
861,24,Canada,3,3,8,14,2000,0,288
862,25,Spain,3,3,5,11,2000,0,316
863,26,Turkey,3,0,2,5,2000,0,57
864,27,Iran,3,0,1,4,2000,0,33
865,28,Czech_Republic,2,3,3,8,2000,0,111
866,29,Kenya,2,3,2,7,2000,0,56
867,30,Denmark,2,3,1,6,2000,0,89
868,31,Finland,2,1,1,4,2000,0,70
869,32,Austria,2,1,0,3,2000,0,92
870,33,Lithuania,2,0,3,5,2000,0,61
871,34,Azerbaijan,2,0,1,3,2000,0,31
872,34,Bahamas,2,0,1,3,2000,0,25
873,36,Slovenia,2,0,0,2,2000,0,74
874,37,Switzerland,1,6,2,9,2000,0,102
875,38,Indonesia,1,3,2,6,2000,0,35
876,39,Slovakia,1,3,1,5,2000,0,108
877,40,Mexico,1,2,3,6,2000,0,78
878,41,Nigeria,1,2,0,3,2000,0,81
879,42,Algeria,1,1,3,5,2000,0,47
880,43,Uzbekistan,1,1,2,4,2000,0,70
881,44,FR_Yugoslavia,1,1,1,3,2000,0,70
882,44,Latvia,1,1,1,3,2000,0,45
883,46,New_Zealand,1,0,3,4,2000,0,147
884,47,Estonia,1,0,2,3,2000,0,33
885,47,Thailand,1,0,2,3,2000,0,52
886,49,Croatia,1,0,1,2,2000,0,88
887,50,Cameroon,1,0,0,1,2000,0,34
888,50,Colombia,1,0,0,1,2000,0,44
889,50,Mozambique,1,0,0,1,2000,0,4
890,53,Brazil,0,6,6,12,2000,0,189
891,54,Jamaica,0,6,3,9,2000,0,48
892,55,Belgium,0,2,3,5,2000,0,68
893,55,South_Africa,0,2,3,5,2000,0,127
894,57,Argentina,0,2,2,4,2000,0,138
895,58,Chinese_Taipei,0,1,4,5,2000,0,53
896,58,Morocco,0,1,4,5,2000,0,55
897,60,North_Korea,0,1,3,4,2000,0,31
898,61,Moldova,0,1,1,2,2000,0,34
899,61,Saudi_Arabia,0,1,1,2,2000,0,18
900,61,Trinidad_and_Tobago,0,1,1,2,2000,0,19
901,64,Ireland,0,1,0,1,2000,0,64
902,64,Sri_Lanka,0,1,0,1,2000,0,18
903,64,Uruguay,0,1,0,1,2000,0,15
904,64,Vietnam,0,1,0,1,2000,0,7
905,68,Georgia,0,0,6,6,2000,0,36
906,69,Costa_Rica,0,0,2,2,2000,0,7
907,69,Portugal,0,0,2,2,2000,0,61
908,71,Armenia,0,0,1,1,2000,0,25
909,71,Barbados,0,0,1,1,2000,0,18
910,71,Chile,0,0,1,1,2000,0,50
911,71,Iceland,0,0,1,1,2000,0,18
912,71,India,0,0,1,1,2000,0,65
913,71,Israel,0,0,1,1,2000,0,39
914,71,Kuwait,0,0,1,1,2000,0,29
915,71,Kyrgyzstan,0,0,1,1,2000,0,48
916,71,Macedonia,0,0,1,1,2000,0,10
917,71,Qatar,0,0,1,1,2000,0,17
918,1,United_States,36,39,26,101,2004,0,521
919,2,China,32,17,14,63,2004,0,354
920,3,Russia,28,26,36,90,2004,0,442
921,4,Australia,17,16,17,50,2004,0,460
922,5,Japan,16,9,12,37,2004,0,300
923,6,Germany,13,16,20,49,2004,0,427
924,7,France,11,9,13,33,2004,0,307
925,8,Italy,10,11,11,32,2004,0,363
926,9,South_Korea,9,12,9,30,2004,0,249
927,10,Great_Britain,9,9,12,30,2004,0,258
928,11,Cuba,9,7,11,27,2004,0,151
929,12,Hungary,8,6,3,17,2004,0,206
930,13,Ukraine,8,5,9,22,2004,0,239
931,14,Romania,8,5,6,19,2004,0,108
932,15,Greece,6,6,4,16,2004,1,422
933,16,Brazil,5,2,3,10,2004,0,234
934,17,Norway,5,0,1,6,2004,0,44
935,18,Netherlands,4,9,9,22,2004,0,210
936,19,Sweden,4,2,1,7,2004,0,114
937,20,Spain,3,11,6,20,2004,0,310
938,21,Canada,3,6,3,12,2004,0,256
939,22,Turkey,3,3,4,10,2004,0,64
940,23,Poland,3,2,5,10,2004,0,194
941,24,New_Zealand,3,2,0,5,2004,0,148
942,25,Thailand,3,1,4,8,2004,0,39
943,26,Belarus,2,5,6,13,2004,0,151
944,27,Austria,2,4,1,7,2004,0,70
945,28,Ethiopia,2,3,2,7,2004,0,26
946,29,Iran,2,2,2,6,2004,0,37
947,29,Slovakia,2,2,2,6,2004,0,63
948,31,Chinese_Taipei,2,2,1,5,2004,0,88
949,32,Georgia,2,2,0,4,2004,0,32
950,33,Bulgaria,2,1,9,12,2004,0,95
951,34,Denmark,2,1,5,8,2004,0,84
952,35,Jamaica,2,1,2,5,2004,0,47
953,35,Uzbekistan,2,1,2,5,2004,0,69
954,37,Morocco,2,1,0,3,2004,0,55
955,38,Argentina,2,0,4,6,2004,0,149
956,39,Chile,2,0,1,3,2004,0,22
957,40,Kazakhstan,1,4,3,8,2004,0,114
958,41,Kenya,1,4,2,7,2004,0,46
959,42,Czech_Republic,1,3,5,9,2004,0,136
960,43,South_Africa,1,3,2,6,2004,0,106
961,44,Croatia,1,2,2,5,2004,0,81
962,45,Lithuania,1,2,0,3,2004,0,59
963,46,Egypt,1,1,3,5,2004,0,96
964,46,Switzerland,1,1,3,5,2004,0,94
965,48,Indonesia,1,1,2,4,2004,0,30
966,49,Zimbabwe,1,1,1,3,2004,0,12
967,50,Azerbaijan,1,0,4,5,2004,0,36
968,51,Belgium,1,0,2,3,2004,0,50
969,52,Bahamas,1,0,1,2,2004,0,22
970,52,Israel,1,0,1,2,2004,0,36
971,54,Cameroon,1,0,0,1,2004,0,17
972,54,Dominican_Republic,1,0,0,1,2004,0,33
973,54,United_Arab_Emirates,1,0,0,1,2004,0,4
974,57,North_Korea,0,4,1,5,2004,0,36
975,58,Latvia,0,4,0,4,2004,0,32
976,59,Mexico,0,3,1,4,2004,0,109
977,60,Portugal,0,2,1,3,2004,0,80
978,61,Finland,0,2,0,2,2004,0,53
979,61,Serbia_and_Montenegro,0,2,0,2,2004,0,85
980,63,Slovenia,0,1,3,4,2004,0,78
981,64,Estonia,0,1,2,3,2004,0,42
982,65,Hong_Kong,0,1,0,1,2004,0,30
983,65,India,0,1,0,1,2004,0,73
984,65,Paraguay,0,1,0,1,2004,0,21
985,68,Colombia,0,0,2,2,2004,0,53
986,68,Nigeria,0,0,2,2,2004,0,66
987,68,Venezuela,0,0,2,2,2004,0,48
988,71,Eritrea,0,0,1,1,2004,0,4
989,71,Mongolia,0,0,1,1,2004,0,20
990,71,Syria,0,0,1,1,2004,0,6
991,71,Trinidad_and_Tobago,0,0,1,1,2004,0,19
992,1,China,48,22,30,100,2008,1,567
993,2,United_States,36,39,37,112,2008,0,575
994,3,Russia,24,13,23,60,2008,0,451
995,4,Great_Britain,19,13,19,51,2008,0,301
996,5,Germany,16,11,14,41,2008,0,412
997,6,Australia,14,15,17,46,2008,0,429
998,7,South_Korea,13,11,8,32,2008,0,253
999,8,Japan,9,8,8,25,2008,0,324
1000,9,Italy,8,9,10,27,2008,0,332
1001,10,France,7,16,20,43,2008,0,308
1002,11,Netherlands,7,5,4,16,2008,0,233
1003,12,Ukraine,7,4,11,22,2008,0,243
1004,13,Kenya,6,4,6,16,2008,0,46
1005,14,Spain,5,11,3,19,2008,0,281
1006,15,Jamaica,5,4,2,11,2008,0,50
1007,16,Poland,4,5,2,11,2008,0,255
1008,17,Ethiopia,4,2,1,7,2008,0,27
1009,18,Romania,4,1,4,9,2008,0,101
1010,19,Cuba,3,10,17,30,2008,0,154
1011,20,Canada,3,9,8,20,2008,0,332
1012,21,Hungary,3,5,2,10,2008,0,169
1013,22,Norway,3,5,1,9,2008,0,80
1014,23,Brazil,3,4,10,17,2008,0,258
1015,24,Belarus,3,4,7,14,2008,0,175
1016,25,Czech_Republic,3,3,1,7,2008,0,131
1017,26,Slovakia,3,3,0,6,2008,0,57
1018,27,New_Zealand,3,2,4,9,2008,0,178
1019,28,Georgia,3,2,2,7,2008,0,35
1020,29,Kazakhstan,2,3,4,9,2008,0,130
1021,30,Denmark,2,2,3,7,2008,0,80
1022,31,North_Korea,2,2,2,6,2008,0,58
1023,31,Thailand,2,2,2,6,2008,0,47
1024,33,Mongolia,2,2,0,4,2008,0,28
1025,34,Switzerland,2,1,4,7,2008,0,79
1026,35,Argentina,2,0,4,6,2008,0,131
1027,36,Mexico,2,0,2,4,2008,0,83
1028,37,Belgium,2,0,0,2,2008,0,94
1029,38,Zimbabwe,1,3,0,4,2008,0,13
1030,39,Slovenia,1,2,2,5,2008,0,61
1031,40,Azerbaijan,1,1,4,6,2008,0,44
1032,40,Indonesia,1,1,4,6,2008,0,18
1033,42,Bulgaria,1,1,3,5,2008,0,70
1034,42,Turkey,1,1,3,5,2008,0,67
1035,44,Chinese_Taipei,1,1,2,4,2008,0,79
1036,44,Finland,1,1,2,4,2008,0,57
1037,46,Latvia,1,1,1,3,2008,0,47
1038,47,Dominican_Republic,1,1,0,2,2008,0,24
1039,47,Estonia,1,1,0,2,2008,0,47
1040,47,Portugal,1,1,0,2,2008,0,77
1041,47,Trinidad_and_Tobago,1,1,0,2,2008,0,28
1042,51,India,1,0,2,3,2008,0,53
1043,52,Iran,1,0,1,2,2008,0,54
1044,53,Cameroon,1,0,0,1,2008,0,32
1045,53,Panama,1,0,0,1,2008,0,5
1046,53,Tunisia,1,0,0,1,2008,0,26
1047,56,Sweden,0,4,1,5,2008,0,122
1048,57,Lithuania,0,3,2,5,2008,0,71
1049,57,Nigeria,0,3,2,5,2008,0,74
1050,59,Croatia,0,2,3,5,2008,0,99
1051,60,Colombia,0,2,1,3,2008,0,67
1052,60,Greece,0,2,1,3,2008,0,148
1053,62,Armenia,0,1,4,5,2008,0,24
1054,63,Uzbekistan,0,1,3,4,2008,0,56
1055,64,Austria,0,1,2,3,2008,0,66
1056,64,Ireland,0,1,2,3,2008,0,55
1057,64,Kyrgyzstan,0,1,2,3,2008,0,20
1058,64,Serbia,0,1,2,3,2008,0,87
1059,68,Algeria,0,1,1,2,2008,0,56
1060,68,Bahamas,0,1,1,2,2008,0,25
1061,68,Morocco,0,1,1,2,2008,0,47
1062,68,Tajikistan,0,1,1,2,2008,0,15
1063,72,Chile,0,1,0,1,2008,0,26
1064,72,Ecuador,0,1,0,1,2008,0,25
1065,72,Iceland,0,1,0,1,2008,0,27
1066,72,Malaysia,0,1,0,1,2008,0,27
1067,72,Samoa,0,1,0,1,2008,0,6
1068,72,Singapore,0,1,0,1,2008,0,25
1069,72,South_Africa,0,1,0,1,2008,0,134
1070,72,Sudan,0,1,0,1,2008,0,9
1071,72,Vietnam,0,1,0,1,2008,0,13
1072,81,Egypt,0,0,2,2,2008,0,100
1073,82,Afghanistan,0,0,1,1,2008,0,4
1074,82,Israel,0,0,1,1,2008,0,43
1075,82,Mauritius,0,0,1,1,2008,0,11
1076,82,Moldova,0,0,1,1,2008,0,29
1077,82,Togo,0,0,1,1,2008,0,4
1078,82,Venezuela,0,0,1,1,2008,0,108
1079,1,United_States,48,26,30,104,2012,0,517
1080,2,China,39,31,22,92,2012,0,354
1081,3,Great_Britain,29,18,18,65,2012,1,525
1082,4,Russia,18,21,26,65,2012,0,422
1083,5,South_Korea,13,9,9,31,2012,0,243
1084,6,Germany,11,20,13,44,2012,0,374
1085,7,France,11,11,13,35,2012,0,323
1086,8,Australia,8,15,12,35,2012,0,398
1087,9,Italy,8,9,11,28,2012,0,281
1088,10,Hungary,8,4,6,18,2012,0,151
1089,11,Japan,7,14,17,38,2012,0,287
1090,12,Iran,7,5,1,13,2012,0,52
1091,13,Netherlands,6,6,8,20,2012,0,169
1092,14,New_Zealand,6,2,5,13,2012,0,178
1093,15,Ukraine,5,4,10,19,2012,0,230
1094,16,Cuba,5,3,7,15,2012,0,109
1095,17,Spain,4,10,6,20,2012,0,274
1096,18,Jamaica,4,5,4,13,2012,0,45
1097,19,Czech_Republic,4,4,3,11,2012,0,126
1098,20,South_Africa,4,1,1,6,2012,0,124
1099,21,North_Korea,4,0,2,6,2012,0,51
1100,22,Brazil,3,5,9,17,2012,0,236
1101,23,Kazakhstan,3,2,6,11,2012,0,113
1102,23,Poland,3,2,6,11,2012,0,208
1103,25,Ethiopia,3,2,3,8,2012,0,33
1104,26,Croatia,3,1,2,6,2012,0,107
1105,27,Canada,2,6,10,18,2012,0,272
1106,28,Belarus,2,5,3,10,2012,0,160
1107,29,Kenya,2,4,7,13,2012,0,47
1108,30,Denmark,2,4,3,9,2012,0,111
1109,31,Romania,2,4,1,7,2012,0,105
1110,32,Azerbaijan,2,2,5,9,2012,0,52
1111,33,Switzerland,2,2,0,4,2012,0,94
1112,34,Norway,2,1,1,4,2012,0,61
1113,35,Lithuania,2,0,3,5,2012,0,62
1114,36,Tunisia,2,0,1,3,2012,0,83
1115,37,Sweden,1,4,3,8,2012,0,133
1116,38,Colombia,1,3,5,9,2012,0,101
1117,39,Mexico,1,3,4,8,2012,0,99
1118,40,Georgia,1,2,3,6,2012,0,34
1119,41,Ireland,1,1,4,6,2012,0,64
1120,42,Argentina,1,1,2,4,2012,0,137
1121,42,Serbia,1,1,2,4,2012,0,116
1122,42,Slovenia,1,1,2,4,2012,0,65
1123,42,Trinidad_and_Tobago,1,1,2,4,2012,0,25
1124,46,Turkey,1,1,1,3,2012,0,112
1125,47,Dominican_Republic,1,1,0,2,2012,0,33
1126,48,Chinese_Taipei,1,0,1,2,2012,0,44
1127,48,Latvia,1,0,1,2,2012,0,41
1128,50,Algeria,1,0,0,1,2012,0,38
1129,50,Bahamas,1,0,0,1,2012,0,21
1130,50,Bahrain,1,0,0,1,2012,0,12
1131,50,Grenada,1,0,0,1,2012,0,8
1132,50,Uganda,1,0,0,1,2012,0,15
1133,50,Venezuela,1,0,0,1,2012,0,68
1134,56,Egypt,0,3,1,4,2012,0,109
1135,57,India,0,2,4,6,2012,0,79
1136,58,Mongolia,0,2,3,5,2012,0,29
1137,59,Thailand,0,2,2,4,2012,0,37
1138,60,Bulgaria,0,2,1,3,2012,0,63
1139,60,Finland,0,2,1,3,2012,0,56
1140,60,Indonesia,0,2,1,3,2012,0,22
1141,63,Slovakia,0,1,3,4,2012,0,47
1142,64,Belgium,0,1,2,3,2012,0,111
1143,65,Armenia,0,1,1,2,2012,0,24
1144,65,Estonia,0,1,1,2,2012,0,32
1145,65,Malaysia,0,1,1,2,2012,0,28
1146,65,Puerto_Rico,0,1,1,2,2012,0,25
1147,65,Qatar,0,1,1,2,2012,0,12
1148,70,Botswana,0,1,0,1,2012,0,4
1149,70,Cyprus,0,1,0,1,2012,0,13
1150,70,Gabon,0,1,0,1,2012,0,21
1151,70,Guatemala,0,1,0,1,2012,0,19
1152,70,Montenegro,0,1,0,1,2012,0,33
1153,70,Portugal,0,1,0,1,2012,0,76
1154,76,Uzbekistan,0,0,3,3,2012,0,53
1155,77,Greece,0,0,2,2,2012,0,102
1156,77,Singapore,0,0,2,2,2012,0,23
1157,79,Afghanistan,0,0,1,1,2012,0,6
1158,79,Cameroon,0,0,1,1,2012,0,32
1159,79,Hong_Kong,0,0,1,1,2012,0,41
1160,79,Kuwait,0,0,1,1,2012,0,10
1161,79,Morocco,0,0,1,1,2012,0,63
1162,79,Saudi_Arabia,0,0,1,1,2012,0,18
1163,79,Tajikistan,0,0,1,1,2012,0,16
1164,79,Vietnam,0,0,1,1,2012,0,18
1165,1,United_States,46,37,38,121,2016,0,544
1166,2,Great_Britain,27,23,17,67,2016,0,357
1167,3,China,26,18,26,70,2016,0,378
1168,4,Russia,19,17,20,56,2016,0,279
1169,5,Germany,17,10,15,42,2016,0,413
1170,6,Japan,12,8,21,41,2016,0,335
1171,7,France,10,18,14,42,2016,0,390
1172,8,South_Korea,9,3,9,21,2016,0,199
1173,9,Italy,8,12,8,28,2016,0,305
1174,10,Australia,8,11,10,29,2016,0,414
1175,11,Netherlands,8,7,4,19,2016,0,229
1176,12,Hungary,8,3,4,15,2016,0,153
1177,13,Brazil,7,6,6,19,2016,1,448
1178,14,Spain,7,4,6,17,2016,0,303
1179,15,Kenya,6,6,1,13,2016,0,79
1180,16,Jamaica,6,3,2,11,2016,0,56
1181,17,Croatia,5,3,2,10,2016,0,85
1182,18,Cuba,5,2,4,11,2016,0,117
1183,19,New_Zealand,4,9,5,18,2016,0,195
1184,20,Canada,4,3,15,22,2016,0,301
1185,21,Uzbekistan,4,2,7,13,2016,0,70
1186,22,Colombia,3,2,3,8,2016,0,143
1187,23,Switzerland,3,2,2,7,2016,0,98
1188,24,Iran,3,1,4,8,2016,0,63
1189,25,Greece,3,1,2,6,2016,0,92
1190,26,Argentina,3,1,0,4,2016,0,213
1191,27,Denmark,2,6,7,15,2016,0,117
1192,28,Sweden,2,6,3,11,2016,0,150
1193,29,South_Africa,2,6,2,10,2016,0,135
1194,30,Kazakhstan,2,5,10,17,2016,0,101
1195,31,Ukraine,2,5,4,11,2016,0,201
1196,32,Serbia,2,4,2,8,2016,0,103
1197,33,Poland,2,3,6,11,2016,0,230
1198,34,North_Korea,2,3,2,7,2016,0,30
1199,35,Belgium,2,2,2,6,2016,0,104
1200,35,Thailand,2,2,2,6,2016,0,54
1201,37,Slovakia,2,2,0,4,2016,0,51
1202,38,Georgia,2,1,4,7,2016,0,40
1203,39,Azerbaijan,1,7,10,18,2016,0,56
1204,40,Belarus,1,4,4,9,2016,0,120
1205,41,Turkey,1,3,4,8,2016,0,100
1206,42,Armenia,1,3,0,4,2016,0,31
1207,43,Czech_Republic,1,2,7,10,2016,0,103
1208,44,Ethiopia,1,2,5,8,2016,0,37
1209,45,Slovenia,1,2,1,4,2016,0,63
1210,46,Indonesia,1,2,0,3,2016,0,24
1211,47,Romania,1,1,2,4,2016,0,94
1212,48,Bahrain,1,1,0,2,2016,0,33
1213,48,Vietnam,1,1,0,2,2016,0,22
1214,50,Chinese_Taipei,1,0,2,3,2016,0,55
1215,51,Bahamas,1,0,1,2,2016,0,29
1216,51,Independent_Olympic_Athletes,1,0,1,2,2016,0,29
1217,51,Ivory_Coast,1,0,1,2,2016,0,29
1218,54,Fiji,1,0,0,1,2016,0,53
1219,54,Jordan,1,0,0,1,2016,0,8
1220,54,Kosovo,1,0,0,1,2016,0,8
1221,54,Puerto_Rico,1,0,0,1,2016,0,40
1222,54,Singapore,1,0,0,1,2016,0,24
1223,54,Tajikistan,1,0,0,1,2016,0,7
1224,60,Malaysia,0,4,1,5,2016,0,32
1225,61,Mexico,0,3,2,5,2016,0,122
1226,62,Venezuela,0,2,1,3,2016,0,85
1227,63,Algeria,0,2,0,2,2016,0,64
1228,63,Ireland,0,2,0,2,2016,0,76
1229,65,Lithuania,0,1,3,4,2016,0,67
1230,66,Bulgaria,0,1,2,3,2016,0,50
1231,67,India,0,1,1,2,2016,0,112
1232,67,Mongolia,0,1,1,2,2016,0,43
1233,69,Burundi,0,1,0,1,2016,0,9
1234,69,Grenada,0,1,0,1,2016,0,6
1235,69,Niger,0,1,0,1,2016,0,6
1236,69,Philippines,0,1,0,1,2016,0,13
1237,69,Qatar,0,1,0,1,2016,0,37
1238,74,Norway,0,0,4,4,2016,0,62
1239,75,Egypt,0,0,3,3,2016,0,118
1240,75,Tunisia,0,0,3,3,2016,0,61
1241,77,Israel,0,0,2,2,2016,0,47
1242,78,Austria,0,0,1,1,2016,0,67
1243,78,Dominican_Republic,0,0,1,1,2016,0,26
1244,78,Estonia,0,0,1,1,2016,0,46
1245,78,Finland,0,0,1,1,2016,0,54
1246,78,Morocco,0,0,1,1,2016,0,48
1247,78,Nigeria,0,0,1,1,2016,0,71
1248,78,Portugal,0,0,1,1,2016,0,90
1249,78,Trinidad_and_Tobago,0,0,1,1,2016,0,28
1250,78,United_Arab_Emirates,0,0,1,1,2016,0,12
1251,1,United_States,39,41,33,113,2020,0,633
1252,2,China,38,32,19,89,2020,0,417
1253,3,Japan,27,14,17,58,2020,1,613
1254,4,Great_Britain,22,20,22,64,2020,0,392
1255,5,ROC,20,28,23,71,2020,0,392
1256,6,Australia,17,7,22,46,2020,0,489
1257,7,Netherlands,10,12,14,36,2020,0,282
1258,8,France,10,12,11,33,2020,0,396
1259,9,Germany,10,11,16,37,2020,0,415
1260,10,Italy,10,10,20,40,2020,0,377
1261,11,Canada,7,7,10,24,2020,0,386
1262,12,Brazil,7,6,8,21,2020,0,319
1263,13,New_Zealand,7,6,7,20,2020,0,228
1264,14,Cuba,7,3,5,15,2020,0,69
1265,15,Hungary,6,7,7,20,2020,0,171
1266,16,South_Korea,6,4,10,20,2020,0,237
1267,17,Poland,4,5,5,14,2020,0,218
1268,18,Czech_Republic,4,4,3,11,2020,0,115
1269,19,Kenya,4,4,2,10,2020,0,87
1270,20,Norway,4,2,2,8,2020,0,93
1271,21,Jamaica,4,1,4,9,2020,0,61
1272,22,Spain,3,8,6,17,2020,0,334
1273,23,Sweden,3,6,0,9,2020,0,136
1274,24,Switzerland,3,4,6,13,2020,0,116
1275,25,Denmark,3,4,4,11,2020,0,108
1276,26,Croatia,3,3,2,8,2020,0,60
1277,27,Iran,3,2,2,7,2020,0,65
1278,28,Serbia,3,1,5,9,2020,0,87
1279,29,Belgium,3,1,3,7,2020,0,130
1280,30,Bulgaria,3,1,2,6,2020,0,42
1281,31,Slovenia,3,1,1,5,2020,0,53
1282,32,Uzbekistan,3,0,2,5,2020,0,67
1283,33,Georgia,2,5,1,8,2020,0,35
1284,34,Chinese_Taipei,2,4,6,12,2020,0,68
1285,35,Turkey,2,2,9,13,2020,0,107
1286,36,Greece,2,1,1,4,2020,0,82
1287,36,Uganda,2,1,1,4,2020,0,25
1288,38,Ecuador,2,1,0,3,2020,0,47
1289,39,Ireland,2,0,2,4,2020,0,125
1290,39,Israel,2,0,2,4,2020,0,90
1291,41,Qatar,2,0,1,3,2020,0,16
1292,42,Bahamas,2,0,0,2,2020,0,16
1293,42,Kosovo,2,0,0,2,2020,0,11
1294,44,Ukraine,1,6,12,19,2020,0,153
1295,45,Belarus,1,3,3,7,2020,0,103
1296,46,Romania,1,3,0,4,2020,0,104
1297,46,Venezuela,1,3,0,4,2020,0,43
1298,48,India,1,2,4,7,2020,0,126
1299,49,Hong_Kong,1,2,3,6,2020,0,126
1300,50,Philippines,1,2,1,4,2020,0,19
1301,50,Slovakia,1,2,1,4,2020,0,41
1302,52,South_Africa,1,2,0,3,2020,0,181
1303,53,Austria,1,1,5,7,2020,0,76
1304,54,Egypt,1,1,4,6,2020,0,140
1305,55,Indonesia,1,1,3,5,2020,0,28
1306,56,Ethiopia,1,1,2,4,2020,0,37
1307,56,Portugal,1,1,2,4,2020,0,93
1308,58,Tunisia,1,1,0,2,2020,0,63
1309,59,Estonia,1,0,1,2,2020,0,33
1310,59,Fiji,1,0,1,2,2020,0,32
1311,59,Latvia,1,0,1,2,2020,0,33
1312,59,Thailand,1,0,1,2,2020,0,41
1313,63,Bermuda,1,0,0,1,2020,0,2
1314,63,Morocco,1,0,0,1,2020,0,46
1315,63,Puerto_Rico,1,0,0,1,2020,0,37
1316,66,Colombia,0,4,1,5,2020,0,69
1317,67,Azerbaijan,0,3,4,7,2020,0,44
1318,68,Dominican_Republic,0,3,2,5,2020,0,66
1319,69,Armenia,0,2,2,4,2020,0,17
1320,70,Kyrgyzstan,0,2,1,3,2020,0,16
1321,71,Mongolia,0,1,3,4,2020,0,43
1322,72,Argentina,0,1,2,3,2020,0,189
1323,72,San_Marino,0,1,2,3,2020,0,5
1324,74,Jordan,0,1,1,2,2020,0,14
1325,74,Malaysia,0,1,1,2,2020,0,30
1326,74,Nigeria,0,1,1,2,2020,0,53
1327,77,Bahrain,0,1,0,1,2020,0,32
1328,77,Lithuania,0,1,0,1,2020,0,42
1329,77,Namibia,0,1,0,1,2020,0,11
1330,77,North_Macedonia,0,1,0,1,2020,0,8
1331,77,Saudi_Arabia,0,1,0,1,2020,0,33
1332,77,Turkmenistan,0,1,0,1,2020,0,9
1333,83,Kazakhstan,0,0,8,8,2020,0,97
1334,84,Mexico,0,0,4,4,2020,0,162
1335,85,Finland,0,0,2,2,2020,0,45
1336,86,Botswana,0,0,1,1,2020,0,14
1337,86,Burkina_Faso,0,0,1,1,2020,0,7
1338,86,Ghana,0,0,1,1,2020,0,14
1339,86,Grenada,0,0,1,1,2020,0,6
1340,86,Ivory_Coast,0,0,1,1,2020,0,31
1341,86,Kuwait,0,0,1,1,2020,0,10
1342,86,Moldova,0,0,1,1,2020,0,20
1343,86,Syria,0,0,1,1,2020,0,6
1344,1,United_States,40,44,42,126,2024,0,619
1345,2,China,40,27,24,91,2024,0,396
1346,3,Japan,20,12,13,45,2024,0,430
1347,4,Australia,18,19,16,53,2024,0,474
1348,5,France,16,26,22,64,2024,1,601
1349,6,Netherlands,15,7,12,34,2024,0,288
1350,7,Great_Britain,14,22,29,65,2024,0,343
1351,8,South_Korea,13,9,10,32,2024,0,343
1352,9,Italy,12,13,15,40,2024,0,397
1353,10,Germany,12,13,8,33,2024,0,457
1354,11,New_Zealand,10,7,3,20,2024,0,208
1355,12,Canada,9,7,11,27,2024,0,332
1356,13,Uzbekistan,8,2,3,13,2024,0,88
1357,14,Hungary,6,7,6,19,2024,0,177
1358,15,Spain,5,4,9,18,2024,0,400
1359,16,Sweden,4,4,3,11,2024,0,125
1360,17,Kenya,4,2,5,11,2024,0,74
1361,18,Norway,4,1,3,8,2024,0,109
1362,19,Ireland,4,0,3,7,2024,0,143
1363,20,Brazil,3,7,10,20,2024,0,289
1364,21,Iran,3,6,3,12,2024,0,289
1365,22,Ukraine,3,5,4,12,2024,0,141
1366,23,Romania,3,4,2,9,2024,0,96
1367,24,Georgia,3,3,1,7,2024,0,28
1368,25,Belgium,3,1,6,10,2024,0,177
1369,26,Bulgaria,3,1,3,7,2024,0,46
1370,27,Serbia,3,1,1,5,2024,0,114
1371,28,Czech_Republic,3,0,2,5,2024,0,114
1372,29,Denmark,2,2,5,9,2024,0,128
1373,30,Azerbaijan,2,2,3,7,2024,0,48
1374,30,Croatia,2,2,3,7,2024,0,73
1375,32,Cuba,2,1,6,9,2024,0,61
1376,33,Bahrain,2,1,1,4,2024,0,14
1377,34,Slovenia,2,1,0,3,2024,0,94
1378,35,Chinese_Taipei,2,0,5,7,2024,0,60
1379,36,Austria,2,0,3,5,2024,0,84
1380,37,Hong_Kong,2,0,2,4,2024,0,84
1381,37,Philippines,2,0,2,4,2024,0,22
1382,39,Algeria,2,0,1,3,2024,0,46
1383,39,Indonesia,2,0,1,3,2024,0,29
1384,41,Israel,1,5,1,7,2024,0,89
1385,42,Poland,1,4,5,10,2024,0,226
1386,43,Kazakhstan,1,3,3,7,2024,0,79
1387,44,Jamaica,1,3,2,6,2024,0,65
1388,44,South_Africa,1,3,2,6,2024,0,141
1389,44,Thailand,1,3,2,6,2024,0,52
1390,47,Ethiopia,1,3,0,4,2024,0,33
1391,48,Switzerland,1,2,5,8,2024,0,137
1392,49,Ecuador,1,2,2,5,2024,0,40
1393,50,Portugal,1,2,1,4,2024,0,75
1394,51,Greece,1,1,6,8,2024,0,100
1395,52,Argentina,1,1,1,3,2024,0,143
1396,52,Egypt,1,1,1,3,2024,0,155
1397,52,Tunisia,1,1,1,3,2024,0,26
1398,55,Botswana,1,1,0,2,2024,0,14
1399,55,Chile,1,1,0,2,2024,0,48
1400,55,Saint_Lucia,1,1,0,2,2024,0,4
1401,55,Uganda,1,1,0,2,2024,0,25
1402,59,Dominican_Republic,1,0,2,3,2024,0,59
1403,60,Guatemala,1,0,1,2,2024,0,16
1404,60,Morocco,1,0,1,2,2024,0,61
1405,62,Dominica,1,0,0,1,2024,0,4
1406,62,Pakistan,1,0,0,1,2024,0,7
1407,64,Turkey,0,3,5,8,2024,0,7
1408,65,Mexico,0,3,2,5,2024,0,108
1409,66,Armenia,0,3,1,4,2024,0,15
1410,66,Colombia,0,3,1,4,2024,0,88
1411,68,Kyrgyzstan,0,2,4,6,2024,0,16
1412,68,North_Korea,0,2,4,6,2024,0,16
1413,70,Lithuania,0,2,2,4,2024,0,51
1414,71,India,0,1,5,6,2024,0,112
1415,72,Moldova,0,1,3,4,2024,0,112
1416,73,Kosovo,0,1,1,2,2024,0,9
1417,74,Cyprus,0,1,0,1,2024,0,15
1418,74,Fiji,0,1,0,1,2024,0,36
1419,74,Jordan,0,1,0,1,2024,0,12
1420,74,Mongolia,0,1,0,1,2024,0,32
1421,74,Panama,0,1,0,1,2024,0,8
1422,79,Tajikistan,0,0,3,3,2024,0,14
1423,80,Albania,0,0,2,2,2024,0,8
1424,80,Grenada,0,0,2,2,2024,0,6
1425,80,Malaysia,0,0,2,2,2024,0,26
1426,80,Puerto_Rico,0,0,2,2,2024,0,51
1427,84,Cabo_Verde,0,0,1,1,2024,0,7
1428,84,Ivory_Coast,0,0,1,1,2024,0,7
1429,84,Peru,0,0,1,1,2024,0,26
1430,84,Qatar,0,0,1,1,2024,0,13
1431,84,Refugee_Olympic_Team,0,0,1,1,2024,0,13
1432,84,Singapore,0,0,1,1,2024,0,23
1433,84,Slovakia,0,0,1,1,2024,0,28
1434,84,Zambia,0,0,1,1,2024,0,31
